###################################################################################################################################################################
#..............................................................................................#...............................................#..................#
#..............................................................................................#...............................................#..................#
#..............................................................................................#...............#...............................#..................#
#..............................................................................................#...............#...............................#..................#
#..............................................................................................#...............#...............................#..................#
#..............................................................................................#...............#...............................#..................#
#........########################..............................................................#...............#...............................#..................#
#........#......................#..............................................................#...............#...............................##########...#######
#........#..##################..#..............................................................................#..................................................#
#........#..#................#..#..............................................................................#..................................................#
#........#..#................#..#..............................................................####################################################################
#........#..#######....#######..#.................................................................................................................................#
#........#......................#.................................................................................................................................#
#........#......................#.................................................................................................................................#
#........##########...###########.................................................................................................................................#
#.................................................................................................................................................................#
#..................................................................##########.....................................................................................#
#...............................................................################..................................................................................#
#...............................................................##################................................................................................#
#........................................................#########################................................................................................#
#..............................................................########################...........................................................................#
#..............................................................################...................................................................................#
#................................................#....#######################.....................................................................................#
#..............................................###...........############################.........................................................................#
#.............................................#######.........#######################.............................................................................#
#..........................................#############......################....................................................................................#
#.....................................##########################.....#######......................................................................................#
#......................................#########################..................................................................................................#
#........................................########################.................................................................................................#
#.............................................##################..................................................................................................#
#.....................................................#########...................................................................................................#
#.................................................................................................................................................................#
#.................................................................................................................................................................#
#.................................................................................................................................................................#
#.................................................................................................................................................................#
###################################################################################################################################################################


